----------------------------------------
----------------------------------------
----------------------------------------
----XXXXXXXXXXXXXXX---------------------
----X-------------XXX-------------------
----X-E-------------XX------------------
----X----------------XX-----------------
----X-----------------XX----------------
----X------------v-----X----------------
----X------------------X----------------
----X------------------X----------------
----X------------------X----------------
----X-----------------XX----------------
-----X---------XXXXX-XX-----------------
-----X-1----XXX----XXX------------------
-----X----XX----------------------------
------X--XX-----------------------------
------X-X-------------------------------
------XX--------------------------------
------X---------------------------------
----------------------------------------
----------------------------------------
----------------------------------------
----------------------------------------
----------------------------------------
